
qw1l	tợ
qwul	tợu
qwjl	tợi
qwcl	tợc
qwfl	tợng
qwnl	tợn
qwml	tợm
qwvl	tợp
qwrl	tợt

qw1o	tuợ
qwuo	tuợu
qwjo	tuợi
qwco	tuợc
qwfo	tuợng
qwno	tuợn
qwmo	tuợm
qwvo	tuợp
qwro	tuợt

qo1l	tọ
qoul	tọu
qojl	tọi
qocl	tọc
qofl	tọng
qonl	tọn
qoml	tọm
qovl	tọp
qorl	tọt

qo1o	toọ
qouo	toọu
qojo	toọi
qoco	toọc
qofo	toọng
qono	toọn
qomo	toọm
qovo	toọp
qoro	toọt

qa1l	tạ
qaul	tạo
qajl	tại
qacl	tạc
qafl	tạng
qanl	tạn
qaml	tạm
qavl	tạp
qarl	tạt

qa1o	toạ
qauo	toạo
qajo	toại
qaco	toạc
qafo	toạng
qano	toạn
qamo	toạm
qavo	toạp
qaro	toạt

qe1l	tẹ
qeul	tẹo
qejl	tẹi
qecl	tẹc
qefl	tẹng
qenl	tẹn
qeml	tẹm
qevl	tẹp
qerl	tẹt

qe1o	toẹ
qeuo	toẹo
qejo	toẹi
qeco	toẹc
qefo	toẹng
qeno	toẹn
qemo	toẹm
qevo	toẹp
qero	toẹt

qd1l	tệ
qdul	tệu
qdjl	tệy
qdcl	tệch
qdfl	tệnh
qdnl	tện
qdml	tệm
qdvl	tệp
qdrl	tệt

qd1o	tuệ
qduo	tuệu
qdjo	tuệy
qdco	tuệch
qdfo	tuệnh
qdno	tuện
qdmo	tuệm
qdvo	tuệp
qdro	tuệt

qi1l	tị
qiul	tịu
qijl	tỵ
qicl	tịch
qifl	tịnh
qinl	tịn
qiml	tịm
qivl	tịp
qirl	tịt

qi1o	tuị
qiuo	tuỵu
qijo	tuỵ
qico	tuỵch
qifo	tuỵnh
qino	tuỵn
qimo	tuỵm
qivo	tuỵp
qiro	tuỵt

qk1l	tịa
qkul	tiệu
qkjl	tiệy
qkcl	tiệc
qkfl	tiệng
qknl	tiện
qkml	tiệm
qkvl	tiệp
qkrl	tiệt

qk1o	tuỵa
qkuo	tuyệu
qkjo	tuyệy
qkco	tuyệc
qkfo	tuyệng
qkno	tuyện
qkmo	tuyệm
qkvo	tuyệp
qkro	tuyệt

ql1l	tộ
qlul	tộu
qljl	tội
qlcl	tộc
qlfl	tộng
qlnl	tộn
qlml	tộm
qlvl	tộp
qlrl	tột

ql1o	toộ
qluo	toộu
qljo	toội
qlco	toộc
qlfo	toộng
qlno	toộn
qlmo	toộm
qlvo	toộp
qlro	toột

qs1l	tạnh
qsul	tậu
qsjl	tậy
qscl	tậc
qsfl	tậng
qsnl	tận
qsml	tậm
qsvl	tập
qsrl	tật

qs1o	toạnh
qsuo	tuậu
qsjo	tuậy
qsco	tuậc
qsfo	tuậng
qsno	tuận
qsmo	tuậm
qsvo	tuập
qsro	tuật

qq1l	tạch
qqul	tạu
qqjl	tạy
qqcl	tặc
qqfl	tặng
qqnl	tặn
qqml	tặm
qqvl	tặp
qqrl	tặt

qq1o	toạch
qquo	toạu
qqjo	toạy
qqco	toặc
qqfo	toặng
qqno	toặn
qqmo	toặm
qqvo	toặp
qqro	toặt

qt1l	tự
qtul	tựu
qtjl	tựi
qtcl	tực
qtfl	tựng
qtnl	tựn
qtml	tựm
qtvl	tựp
qtrl	tựt

qt1o	tựa
qtuo	tượu
qtjo	tượi
qtco	tược
qtfo	tượng
qtno	tượn
qtmo	tượm
qtvo	tượp
qtro	tượt

qp1l	tụ
qpul	tụu
qpjl	tụi
qpcl	tục
qpfl	tụng
qpnl	tụn
qpml	tụm
qpvl	tụp
qprl	tụt

qp1o	tụa
qpuo	tuộu
qpjo	tuội
qpco	tuộc
qpfo	tuộng
qpno	tuộn
qpmo	tuộm
qpvo	tuộp
qpro	tuột

ww1l	thợ
wwul	thợu
wwjl	thợi
wwcl	thợc
wwfl	thợng
wwnl	thợn
wwml	thợm
wwvl	thợp
wwrl	thợt

ww1o	thuợ
wwuo	thuợu
wwjo	thuợi
wwco	thuợc
wwfo	thuợng
wwno	thuợn
wwmo	thuợm
wwvo	thuợp
wwro	thuợt

wo1l	thọ
woul	thọu
wojl	thọi
wocl	thọc
wofl	thọng
wonl	thọn
woml	thọm
wovl	thọp
worl	thọt

wo1o	thoọ
wouo	thoọu
wojo	thoọi
woco	thoọc
wofo	thoọng
wono	thoọn
womo	thoọm
wovo	thoọp
woro	thoọt

wa1l	thạ
waul	thạo
wajl	thại
wacl	thạc
wafl	thạng
wanl	thạn
waml	thạm
wavl	thạp
warl	thạt

wa1o	thoạ
wauo	thoạo
wajo	thoại
waco	thoạc
wafo	thoạng
wano	thoạn
wamo	thoạm
wavo	thoạp
waro	thoạt

we1l	thẹ
weul	thẹo
wejl	thẹi
wecl	thẹc
wefl	thẹng
wenl	thẹn
weml	thẹm
wevl	thẹp
werl	thẹt

we1o	thoẹ
weuo	thoẹo
wejo	thoẹi
weco	thoẹc
wefo	thoẹng
weno	thoẹn
wemo	thoẹm
wevo	thoẹp
wero	thoẹt

wd1l	thệ
wdul	thệu
wdjl	thệy
wdcl	thệch
wdfl	thệnh
wdnl	thện
wdml	thệm
wdvl	thệp
wdrl	thệt

wd1o	thuệ
wduo	thuệu
wdjo	thuệy
wdco	thuệch
wdfo	thuệnh
wdno	thuện
wdmo	thuệm
wdvo	thuệp
wdro	thuệt

wi1l	thị
wiul	thịu
wijl	thỵ
wicl	thịch
wifl	thịnh
winl	thịn
wiml	thịm
wivl	thịp
wirl	thịt

wi1o	thuị
wiuo	thuỵu
wijo	thuỵ
wico	thuỵch
wifo	thuỵnh
wino	thuỵn
wimo	thuỵm
wivo	thuỵp
wiro	thuỵt

wk1l	thịa
wkul	thiệu
wkjl	thiệy
wkcl	thiệc
wkfl	thiệng
wknl	thiện
wkml	thiệm
wkvl	thiệp
wkrl	thiệt

wk1o	thuỵa
wkuo	thuyệu
wkjo	thuyệy
wkco	thuyệc
wkfo	thuyệng
wkno	thuyện
wkmo	thuyệm
wkvo	thuyệp
wkro	thuyệt

wl1l	thộ
wlul	thộu
wljl	thội
wlcl	thộc
wlfl	thộng
wlnl	thộn
wlml	thộm
wlvl	thộp
wlrl	thột

wl1o	thoộ
wluo	thoộu
wljo	thoội
wlco	thoộc
wlfo	thoộng
wlno	thoộn
wlmo	thoộm
wlvo	thoộp
wlro	thoột

ws1l	thạnh
wsul	thậu
wsjl	thậy
wscl	thậc
wsfl	thậng
wsnl	thận
wsml	thậm
wsvl	thập
wsrl	thật

ws1o	thoạnh
wsuo	thuậu
wsjo	thuậy
wsco	thuậc
wsfo	thuậng
wsno	thuận
wsmo	thuậm
wsvo	thuập
wsro	thuật

wq1l	thạch
wqul	thạu
wqjl	thạy
wqcl	thặc
wqfl	thặng
wqnl	thặn
wqml	thặm
wqvl	thặp
wqrl	thặt

wq1o	thoạch
wquo	thoạu
wqjo	thoạy
wqco	thoặc
wqfo	thoặng
wqno	thoặn
wqmo	thoặm
wqvo	thoặp
wqro	thoặt

wt1l	thự
wtul	thựu
wtjl	thựi
wtcl	thực
wtfl	thựng
wtnl	thựn
wtml	thựm
wtvl	thựp
wtrl	thựt

wt1o	thựa
wtuo	thượu
wtjo	thượi
wtco	thược
wtfo	thượng
wtno	thượn
wtmo	thượm
wtvo	thượp
wtro	thượt

wp1l	thụ
wpul	thụu
wpjl	thụi
wpcl	thục
wpfl	thụng
wpnl	thụn
wpml	thụm
wpvl	thụp
wprl	thụt

wp1o	thụa
wpuo	thuộu
wpjo	thuội
wpco	thuộc
wpfo	thuộng
wpno	thuộn
wpmo	thuộm
wpvo	thuộp
wpro	thuột

jw1l	đợ
jwul	đợu
jwjl	đợi
jwcl	đợc
jwfl	đợng
jwnl	đợn
jwml	đợm
jwvl	đợp
jwrl	đợt

jw1o	đuợ
jwuo	đuợu
jwjo	đuợi
jwco	đuợc
jwfo	đuợng
jwno	đuợn
jwmo	đuợm
jwvo	đuợp
jwro	đuợt

jo1l	đọ
joul	đọu
jojl	đọi
jocl	đọc
jofl	đọng
jonl	đọn
joml	đọm
jovl	đọp
jorl	đọt

jo1o	đoọ
jouo	đoọu
jojo	đoọi
joco	đoọc
jofo	đoọng
jono	đoọn
jomo	đoọm
jovo	đoọp
joro	đoọt

ja1l	đạ
jaul	đạo
jajl	đại
jacl	đạc
jafl	đạng
janl	đạn
jaml	đạm
javl	đạp
jarl	đạt

ja1o	đoạ
jauo	đoạo
jajo	đoại
jaco	đoạc
jafo	đoạng
jano	đoạn
jamo	đoạm
javo	đoạp
jaro	đoạt

je1l	đẹ
jeul	đẹo
jejl	đẹi
jecl	đẹc
jefl	đẹng
jenl	đẹn
jeml	đẹm
jevl	đẹp
jerl	đẹt

je1o	đoẹ
jeuo	đoẹo
jejo	đoẹi
jeco	đoẹc
jefo	đoẹng
jeno	đoẹn
jemo	đoẹm
jevo	đoẹp
jero	đoẹt

jd1l	đệ
jdul	đệu
jdjl	đệy
jdcl	đệch
jdfl	đệnh
jdnl	đện
jdml	đệm
jdvl	đệp
jdrl	đệt

jd1o	đuệ
jduo	đuệu
jdjo	đuệy
jdco	đuệch
jdfo	đuệnh
jdno	đuện
jdmo	đuệm
jdvo	đuệp
jdro	đuệt

ji1l	đị
jiul	địu
jijl	đỵ
jicl	địch
jifl	định
jinl	địn
jiml	địm
jivl	địp
jirl	địt

ji1o	đuị
jiuo	đuỵu
jijo	đuỵ
jico	đuỵch
jifo	đuỵnh
jino	đuỵn
jimo	đuỵm
jivo	đuỵp
jiro	đuỵt

jk1l	địa
jkul	điệu
jkjl	điệy
jkcl	điệc
jkfl	điệng
jknl	điện
jkml	điệm
jkvl	điệp
jkrl	điệt

jk1o	đuỵa
jkuo	đuyệu
jkjo	đuyệy
jkco	đuyệc
jkfo	đuyệng
jkno	đuyện
jkmo	đuyệm
jkvo	đuyệp
jkro	đuyệt

jl1l	độ
jlul	độu
jljl	đội
jlcl	độc
jlfl	động
jlnl	độn
jlml	độm
jlvl	độp
jlrl	đột

jl1o	đoộ
jluo	đoộu
jljo	đoội
jlco	đoộc
jlfo	đoộng
jlno	đoộn
jlmo	đoộm
jlvo	đoộp
jlro	đoột

js1l	đạnh
jsul	đậu
jsjl	đậy
jscl	đậc
jsfl	đậng
jsnl	đận
jsml	đậm
jsvl	đập
jsrl	đật

js1o	đoạnh
jsuo	đuậu
jsjo	đuậy
jsco	đuậc
jsfo	đuậng
jsno	đuận
jsmo	đuậm
jsvo	đuập
jsro	đuật

jq1l	đạch
jqul	đạu
jqjl	đạy
jqcl	đặc
jqfl	đặng
jqnl	đặn
jqml	đặm
jqvl	đặp
jqrl	đặt

jq1o	đoạch
jquo	đoạu
jqjo	đoạy
jqco	đoặc
jqfo	đoặng
jqno	đoặn
jqmo	đoặm
jqvo	đoặp
jqro	đoặt

jt1l	đự
jtul	đựu
jtjl	đựi
jtcl	đực
jtfl	đựng
jtnl	đựn
jtml	đựm
jtvl	đựp
jtrl	đựt

jt1o	đựa
jtuo	đượu
jtjo	đượi
jtco	được
jtfo	đượng
jtno	đượn
jtmo	đượm
jtvo	đượp
jtro	đượt

jp1l	đụ
jpul	đụu
jpjl	đụi
jpcl	đục
jpfl	đụng
jpnl	đụn
jpml	đụm
jpvl	đụp
jprl	đụt

jp1o	đụa
jpuo	đuộu
jpjo	đuội
jpco	đuộc
jpfo	đuộng
jpno	đuộn
jpmo	đuộm
jpvo	đuộp
jpro	đuột

dw1l	dợ
dwul	dợu
dwjl	dợi
dwcl	dợc
dwfl	dợng
dwnl	dợn
dwml	dợm
dwvl	dợp
dwrl	dợt

dw1o	duợ
dwuo	duợu
dwjo	duợi
dwco	duợc
dwfo	duợng
dwno	duợn
dwmo	duợm
dwvo	duợp
dwro	duợt

do1l	dọ
doul	dọu
dojl	dọi
docl	dọc
dofl	dọng
donl	dọn
doml	dọm
dovl	dọp
dorl	dọt

do1o	doọ
douo	doọu
dojo	doọi
doco	doọc
dofo	doọng
dono	doọn
domo	doọm
dovo	doọp
doro	doọt

da1l	dạ
daul	dạo
dajl	dại
dacl	dạc
dafl	dạng
danl	dạn
daml	dạm
davl	dạp
darl	dạt

da1o	doạ
dauo	doạo
dajo	doại
daco	doạc
dafo	doạng
dano	doạn
damo	doạm
davo	doạp
daro	doạt

de1l	dẹ
deul	dẹo
dejl	dẹi
decl	dẹc
defl	dẹng
denl	dẹn
deml	dẹm
devl	dẹp
derl	dẹt

de1o	doẹ
deuo	doẹo
dejo	doẹi
deco	doẹc
defo	doẹng
deno	doẹn
demo	doẹm
devo	doẹp
dero	doẹt

dd1l	dệ
ddul	dệu
ddjl	dệy
ddcl	dệch
ddfl	dệnh
ddnl	dện
ddml	dệm
ddvl	dệp
ddrl	dệt

dd1o	duệ
dduo	duệu
ddjo	duệy
ddco	duệch
ddfo	duệnh
ddno	duện
ddmo	duệm
ddvo	duệp
ddro	duệt

di1l	dị
diul	dịu
dijl	dỵ
dicl	dịch
difl	dịnh
dinl	dịn
diml	dịm
divl	dịp
dirl	dịt

di1o	duị
diuo	duỵu
dijo	duỵ
dico	duỵch
difo	duỵnh
dino	duỵn
dimo	duỵm
divo	duỵp
diro	duỵt

dk1l	dịa
dkul	diệu
dkjl	diệy
dkcl	diệc
dkfl	diệng
dknl	diện
dkml	diệm
dkvl	diệp
dkrl	diệt

dk1o	duỵa
dkuo	duyệu
dkjo	duyệy
dkco	duyệc
dkfo	duyệng
dkno	duyện
dkmo	duyệm
dkvo	duyệp
dkro	duyệt

dl1l	dộ
dlul	dộu
dljl	dội
dlcl	dộc
dlfl	dộng
dlnl	dộn
dlml	dộm
dlvl	dộp
dlrl	dột

dl1o	doộ
dluo	doộu
dljo	doội
dlco	doộc
dlfo	doộng
dlno	doộn
dlmo	doộm
dlvo	doộp
dlro	doột

ds1l	dạnh
dsul	dậu
dsjl	dậy
dscl	dậc
dsfl	dậng
dsnl	dận
dsml	dậm
dsvl	dập
dsrl	dật

ds1o	doạnh
dsuo	duậu
dsjo	duậy
dsco	duậc
dsfo	duậng
dsno	duận
dsmo	duậm
dsvo	duập
dsro	duật

dq1l	dạch
dqul	dạu
dqjl	dạy
dqcl	dặc
dqfl	dặng
dqnl	dặn
dqml	dặm
dqvl	dặp
dqrl	dặt

dq1o	doạch
dquo	doạu
dqjo	doạy
dqco	doặc
dqfo	doặng
dqno	doặn
dqmo	doặm
dqvo	doặp
dqro	doặt

dt1l	dự
dtul	dựu
dtjl	dựi
dtcl	dực
dtfl	dựng
dtnl	dựn
dtml	dựm
dtvl	dựp
dtrl	dựt

dt1o	dựa
dtuo	dượu
dtjo	dượi
dtco	dược
dtfo	dượng
dtno	dượn
dtmo	dượm
dtvo	dượp
dtro	dượt

dp1l	dụ
dpul	dụu
dpjl	dụi
dpcl	dục
dpfl	dụng
dpnl	dụn
dpml	dụm
dpvl	dụp
dprl	dụt

dp1o	dụa
dpuo	duộu
dpjo	duội
dpco	duộc
dpfo	duộng
dpno	duộn
dpmo	duộm
dpvo	duộp
dpro	duột

uw1l	chợ
uwul	chợu
uwjl	chợi
uwcl	chợc
uwfl	chợng
uwnl	chợn
uwml	chợm
uwvl	chợp
uwrl	chợt

uw1o	chuợ
uwuo	chuợu
uwjo	chuợi
uwco	chuợc
uwfo	chuợng
uwno	chuợn
uwmo	chuợm
uwvo	chuợp
uwro	chuợt

uo1l	chọ
uoul	chọu
uojl	chọi
uocl	chọc
uofl	chọng
uonl	chọn
uoml	chọm
uovl	chọp
uorl	chọt

uo1o	choọ
uouo	choọu
uojo	choọi
uoco	choọc
uofo	choọng
uono	choọn
uomo	choọm
uovo	choọp
uoro	choọt

ua1l	chạ
uaul	chạo
uajl	chại
uacl	chạc
uafl	chạng
uanl	chạn
uaml	chạm
uavl	chạp
uarl	chạt

ua1o	choạ
uauo	choạo
uajo	choại
uaco	choạc
uafo	choạng
uano	choạn
uamo	choạm
uavo	choạp
uaro	choạt

ue1l	chẹ
ueul	chẹo
uejl	chẹi
uecl	chẹc
uefl	chẹng
uenl	chẹn
ueml	chẹm
uevl	chẹp
uerl	chẹt

ue1o	choẹ
ueuo	choẹo
uejo	choẹi
ueco	choẹc
uefo	choẹng
ueno	choẹn
uemo	choẹm
uevo	choẹp
uero	choẹt

ud1l	chệ
udul	chệu
udjl	chệy
udcl	chệch
udfl	chệnh
udnl	chện
udml	chệm
udvl	chệp
udrl	chệt

ud1o	chuệ
uduo	chuệu
udjo	chuệy
udco	chuệch
udfo	chuệnh
udno	chuện
udmo	chuệm
udvo	chuệp
udro	chuệt

ui1l	chị
uiul	chịu
uijl	chỵ
uicl	chịch
uifl	chịnh
uinl	chịn
uiml	chịm
uivl	chịp
uirl	chịt

ui1o	chuị
uiuo	chuỵu
uijo	chuỵ
uico	chuỵch
uifo	chuỵnh
uino	chuỵn
uimo	chuỵm
uivo	chuỵp
uiro	chuỵt

uk1l	chịa
ukul	chiệu
ukjl	chiệy
ukcl	chiệc
ukfl	chiệng
uknl	chiện
ukml	chiệm
ukvl	chiệp
ukrl	chiệt

uk1o	chuỵa
ukuo	chuyệu
ukjo	chuyệy
ukco	chuyệc
ukfo	chuyệng
ukno	chuyện
ukmo	chuyệm
ukvo	chuyệp
ukro	chuyệt

ul1l	chộ
ulul	chộu
uljl	chội
ulcl	chộc
ulfl	chộng
ulnl	chộn
ulml	chộm
ulvl	chộp
ulrl	chột

ul1o	choộ
uluo	choộu
uljo	choội
ulco	choộc
ulfo	choộng
ulno	choộn
ulmo	choộm
ulvo	choộp
ulro	choột

us1l	chạnh
usul	chậu
usjl	chậy
uscl	chậc
usfl	chậng
usnl	chận
usml	chậm
usvl	chập
usrl	chật

us1o	choạnh
usuo	chuậu
usjo	chuậy
usco	chuậc
usfo	chuậng
usno	chuận
usmo	chuậm
usvo	chuập
usro	chuật

uq1l	chạch
uqul	chạu
uqjl	chạy
uqcl	chặc
uqfl	chặng
uqnl	chặn
uqml	chặm
uqvl	chặp
uqrl	chặt

uq1o	choạch
uquo	choạu
uqjo	choạy
uqco	choặc
uqfo	choặng
uqno	choặn
uqmo	choặm
uqvo	choặp
uqro	choặt

ut1l	chự
utul	chựu
utjl	chựi
utcl	chực
utfl	chựng
utnl	chựn
utml	chựm
utvl	chựp
utrl	chựt

ut1o	chựa
utuo	chượu
utjo	chượi
utco	chược
utfo	chượng
utno	chượn
utmo	chượm
utvo	chượp
utro	chượt

up1l	chụ
upul	chụu
upjl	chụi
upcl	chục
upfl	chụng
upnl	chụn
upml	chụm
upvl	chụp
uprl	chụt

up1o	chụa
upuo	chuộu
upjo	chuội
upco	chuộc
upfo	chuộng
upno	chuộn
upmo	chuộm
upvo	chuộp
upro	chuột

ow1l	trợ
owul	trợu
owjl	trợi
owcl	trợc
owfl	trợng
ownl	trợn
owml	trợm
owvl	trợp
owrl	trợt

ow1o	truợ
owuo	truợu
owjo	truợi
owco	truợc
owfo	truợng
owno	truợn
owmo	truợm
owvo	truợp
owro	truợt

oo1l	trọ
ooul	trọu
oojl	trọi
oocl	trọc
oofl	trọng
oonl	trọn
ooml	trọm
oovl	trọp
oorl	trọt

oo1o	troọ
oouo	troọu
oojo	troọi
ooco	troọc
oofo	troọng
oono	troọn
oomo	troọm
oovo	troọp
ooro	troọt

oa1l	trạ
oaul	trạo
oajl	trại
oacl	trạc
oafl	trạng
oanl	trạn
oaml	trạm
oavl	trạp
oarl	trạt

oa1o	troạ
oauo	troạo
oajo	troại
oaco	troạc
oafo	troạng
oano	troạn
oamo	troạm
oavo	troạp
oaro	troạt

oe1l	trẹ
oeul	trẹo
oejl	trẹi
oecl	trẹc
oefl	trẹng
oenl	trẹn
oeml	trẹm
oevl	trẹp
oerl	trẹt

oe1o	troẹ
oeuo	troẹo
oejo	troẹi
oeco	troẹc
oefo	troẹng
oeno	troẹn
oemo	troẹm
oevo	troẹp
oero	troẹt

od1l	trệ
odul	trệu
odjl	trệy
odcl	trệch
odfl	trệnh
odnl	trện
odml	trệm
odvl	trệp
odrl	trệt

od1o	truệ
oduo	truệu
odjo	truệy
odco	truệch
odfo	truệnh
odno	truện
odmo	truệm
odvo	truệp
odro	truệt

oi1l	trị
oiul	trịu
oijl	trỵ
oicl	trịch
oifl	trịnh
oinl	trịn
oiml	trịm
oivl	trịp
oirl	trịt

oi1o	truị
oiuo	truỵu
oijo	truỵ
oico	truỵch
oifo	truỵnh
oino	truỵn
oimo	truỵm
oivo	truỵp
oiro	truỵt

ok1l	trịa
okul	triệu
okjl	triệy
okcl	triệc
okfl	triệng
oknl	triện
okml	triệm
okvl	triệp
okrl	triệt

ok1o	truỵa
okuo	truyệu
okjo	truyệy
okco	truyệc
okfo	truyệng
okno	truyện
okmo	truyệm
okvo	truyệp
okro	truyệt

ol1l	trộ
olul	trộu
oljl	trội
olcl	trộc
olfl	trộng
olnl	trộn
olml	trộm
olvl	trộp
olrl	trột

ol1o	troộ
oluo	troộu
oljo	troội
olco	troộc
olfo	troộng
olno	troộn
olmo	troộm
olvo	troộp
olro	troột

os1l	trạnh
osul	trậu
osjl	trậy
oscl	trậc
osfl	trậng
osnl	trận
osml	trậm
osvl	trập
osrl	trật

os1o	troạnh
osuo	truậu
osjo	truậy
osco	truậc
osfo	truậng
osno	truận
osmo	truậm
osvo	truập
osro	truật

oq1l	trạch
oqul	trạu
oqjl	trạy
oqcl	trặc
oqfl	trặng
oqnl	trặn
oqml	trặm
oqvl	trặp
oqrl	trặt

oq1o	troạch
oquo	troạu
oqjo	troạy
oqco	troặc
oqfo	troặng
oqno	troặn
oqmo	troặm
oqvo	troặp
oqro	troặt

ot1l	trự
otul	trựu
otjl	trựi
otcl	trực
otfl	trựng
otnl	trựn
otml	trựm
otvl	trựp
otrl	trựt

ot1o	trựa
otuo	trượu
otjo	trượi
otco	trược
otfo	trượng
otno	trượn
otmo	trượm
otvo	trượp
otro	trượt

op1l	trụ
opul	trụu
opjl	trụi
opcl	trục
opfl	trụng
opnl	trụn
opml	trụm
opvl	trụp
oprl	trụt

op1o	trụa
opuo	truộu
opjo	truội
opco	truộc
opfo	truộng
opno	truộn
opmo	truộm
opvo	truộp
opro	truột

rw1l	rợ
rwul	rợu
rwjl	rợi
rwcl	rợc
rwfl	rợng
rwnl	rợn
rwml	rợm
rwvl	rợp
rwrl	rợt

rw1o	ruợ
rwuo	ruợu
rwjo	ruợi
rwco	ruợc
rwfo	ruợng
rwno	ruợn
rwmo	ruợm
rwvo	ruợp
rwro	ruợt

ro1l	rọ
roul	rọu
rojl	rọi
rocl	rọc
rofl	rọng
ronl	rọn
roml	rọm
rovl	rọp
rorl	rọt

ro1o	roọ
rouo	roọu
rojo	roọi
roco	roọc
rofo	roọng
rono	roọn
romo	roọm
rovo	roọp
roro	roọt

ra1l	rạ
raul	rạo
rajl	rại
racl	rạc
rafl	rạng
ranl	rạn
raml	rạm
ravl	rạp
rarl	rạt

ra1o	roạ
rauo	roạo
rajo	roại
raco	roạc
rafo	roạng
rano	roạn
ramo	roạm
ravo	roạp
raro	roạt

re1l	rẹ
reul	rẹo
rejl	rẹi
recl	rẹc
refl	rẹng
renl	rẹn
reml	rẹm
revl	rẹp
rerl	rẹt

re1o	roẹ
reuo	roẹo
rejo	roẹi
reco	roẹc
refo	roẹng
reno	roẹn
remo	roẹm
revo	roẹp
rero	roẹt

rd1l	rệ
rdul	rệu
rdjl	rệy
rdcl	rệch
rdfl	rệnh
rdnl	rện
rdml	rệm
rdvl	rệp
rdrl	rệt

rd1o	ruệ
rduo	ruệu
rdjo	ruệy
rdco	ruệch
rdfo	ruệnh
rdno	ruện
rdmo	ruệm
rdvo	ruệp
rdro	ruệt

ri1l	rị
riul	rịu
rijl	rỵ
ricl	rịch
rifl	rịnh
rinl	rịn
riml	rịm
rivl	rịp
rirl	rịt

ri1o	ruị
riuo	ruỵu
rijo	ruỵ
rico	ruỵch
rifo	ruỵnh
rino	ruỵn
rimo	ruỵm
rivo	ruỵp
riro	ruỵt

rk1l	rịa
rkul	riệu
rkjl	riệy
rkcl	riệc
rkfl	riệng
rknl	riện
rkml	riệm
rkvl	riệp
rkrl	riệt

rk1o	ruỵa
rkuo	ruyệu
rkjo	ruyệy
rkco	ruyệc
rkfo	ruyệng
rkno	ruyện
rkmo	ruyệm
rkvo	ruyệp
rkro	ruyệt

rl1l	rộ
rlul	rộu
rljl	rội
rlcl	rộc
rlfl	rộng
rlnl	rộn
rlml	rộm
rlvl	rộp
rlrl	rột

rl1o	roộ
rluo	roộu
rljo	roội
rlco	roộc
rlfo	roộng
rlno	roộn
rlmo	roộm
rlvo	roộp
rlro	roột

rs1l	rạnh
rsul	rậu
rsjl	rậy
rscl	rậc
rsfl	rậng
rsnl	rận
rsml	rậm
rsvl	rập
rsrl	rật

rs1o	roạnh
rsuo	ruậu
rsjo	ruậy
rsco	ruậc
rsfo	ruậng
rsno	ruận
rsmo	ruậm
rsvo	ruập
rsro	ruật

rq1l	rạch
rqul	rạu
rqjl	rạy
rqcl	rặc
rqfl	rặng
rqnl	rặn
rqml	rặm
rqvl	rặp
rqrl	rặt

rq1o	roạch
rquo	roạu
rqjo	roạy
rqco	roặc
rqfo	roặng
rqno	roặn
rqmo	roặm
rqvo	roặp
rqro	roặt

rt1l	rự
rtul	rựu
rtjl	rựi
rtcl	rực
rtfl	rựng
rtnl	rựn
rtml	rựm
rtvl	rựp
rtrl	rựt

rt1o	rựa
rtuo	rượu
rtjo	rượi
rtco	rược
rtfo	rượng
rtno	rượn
rtmo	rượm
rtvo	rượp
rtro	rượt

rp1l	rụ
rpul	rụu
rpjl	rụi
rpcl	rục
rpfl	rụng
rpnl	rụn
rpml	rụm
rpvl	rụp
rprl	rụt

rp1o	rụa
rpuo	ruộu
rpjo	ruội
rpco	ruộc
rpfo	ruộng
rpno	ruộn
rpmo	ruộm
rpvo	ruộp
rpro	ruột

lw1l	lợ
lwul	lợu
lwjl	lợi
lwcl	lợc
lwfl	lợng
lwnl	lợn
lwml	lợm
lwvl	lợp
lwrl	lợt

lw1o	luợ
lwuo	luợu
lwjo	luợi
lwco	luợc
lwfo	luợng
lwno	luợn
lwmo	luợm
lwvo	luợp
lwro	luợt

lo1l	lọ
loul	lọu
lojl	lọi
locl	lọc
lofl	lọng
lonl	lọn
loml	lọm
lovl	lọp
lorl	lọt

lo1o	loọ
louo	loọu
lojo	loọi
loco	loọc
lofo	loọng
lono	loọn
lomo	loọm
lovo	loọp
loro	loọt

la1l	lạ
laul	lạo
lajl	lại
lacl	lạc
lafl	lạng
lanl	lạn
laml	lạm
lavl	lạp
larl	lạt

la1o	loạ
lauo	loạo
lajo	loại
laco	loạc
lafo	loạng
lano	loạn
lamo	loạm
lavo	loạp
laro	loạt

le1l	lẹ
leul	lẹo
lejl	lẹi
lecl	lẹc
lefl	lẹng
lenl	lẹn
leml	lẹm
levl	lẹp
lerl	lẹt

le1o	loẹ
leuo	loẹo
lejo	loẹi
leco	loẹc
lefo	loẹng
leno	loẹn
lemo	loẹm
levo	loẹp
lero	loẹt

ld1l	lệ
ldul	lệu
ldjl	lệy
ldcl	lệch
ldfl	lệnh
ldnl	lện
ldml	lệm
ldvl	lệp
ldrl	lệt

ld1o	luệ
lduo	luệu
ldjo	luệy
ldco	luệch
ldfo	luệnh
ldno	luện
ldmo	luệm
ldvo	luệp
ldro	luệt

li1l	lị
liul	lịu
lijl	lỵ
licl	lịch
lifl	lịnh
linl	lịn
liml	lịm
livl	lịp
lirl	lịt

li1o	luị
liuo	luỵu
lijo	luỵ
lico	luỵch
lifo	luỵnh
lino	luỵn
limo	luỵm
livo	luỵp
liro	luỵt

lk1l	lịa
lkul	liệu
lkjl	liệy
lkcl	liệc
lkfl	liệng
lknl	liện
lkml	liệm
lkvl	liệp
lkrl	liệt

lk1o	luỵa
lkuo	luyệu
lkjo	luyệy
lkco	luyệc
lkfo	luyệng
lkno	luyện
lkmo	luyệm
lkvo	luyệp
lkro	luyệt

ll1l	lộ
llul	lộu
lljl	lội
llcl	lộc
llfl	lộng
llnl	lộn
llml	lộm
llvl	lộp
llrl	lột

ll1o	loộ
lluo	loộu
lljo	loội
llco	loộc
llfo	loộng
llno	loộn
llmo	loộm
llvo	loộp
llro	loột

ls1l	lạnh
lsul	lậu
lsjl	lậy
lscl	lậc
lsfl	lậng
lsnl	lận
lsml	lậm
lsvl	lập
lsrl	lật

ls1o	loạnh
lsuo	luậu
lsjo	luậy
lsco	luậc
lsfo	luậng
lsno	luận
lsmo	luậm
lsvo	luập
lsro	luật

lq1l	lạch
lqul	lạu
lqjl	lạy
lqcl	lặc
lqfl	lặng
lqnl	lặn
lqml	lặm
lqvl	lặp
lqrl	lặt

lq1o	loạch
lquo	loạu
lqjo	loạy
lqco	loặc
lqfo	loặng
lqno	loặn
lqmo	loặm
lqvo	loặp
lqro	loặt

lt1l	lự
ltul	lựu
ltjl	lựi
ltcl	lực
ltfl	lựng
ltnl	lựn
ltml	lựm
ltvl	lựp
ltrl	lựt

lt1o	lựa
ltuo	lượu
ltjo	lượi
ltco	lược
ltfo	lượng
ltno	lượn
ltmo	lượm
ltvo	lượp
ltro	lượt

lp1l	lụ
lpul	lụu
lpjl	lụi
lpcl	lục
lpfl	lụng
lpnl	lụn
lpml	lụm
lpvl	lụp
lprl	lụt

lp1o	lụa
lpuo	luộu
lpjo	luội
lpco	luộc
lpfo	luộng
lpno	luộn
lpmo	luộm
lpvo	luộp
lpro	luột

nw1l	nợ
nwul	nợu
nwjl	nợi
nwcl	nợc
nwfl	nợng
nwnl	nợn
nwml	nợm
nwvl	nợp
nwrl	nợt

nw1o	nuợ
nwuo	nuợu
nwjo	nuợi
nwco	nuợc
nwfo	nuợng
nwno	nuợn
nwmo	nuợm
nwvo	nuợp
nwro	nuợt

no1l	nọ
noul	nọu
nojl	nọi
nocl	nọc
nofl	nọng
nonl	nọn
noml	nọm
novl	nọp
norl	nọt

no1o	noọ
nouo	noọu
nojo	noọi
noco	noọc
nofo	noọng
nono	noọn
nomo	noọm
novo	noọp
noro	noọt

na1l	nạ
naul	nạo
najl	nại
nacl	nạc
nafl	nạng
nanl	nạn
naml	nạm
navl	nạp
narl	nạt

na1o	noạ
nauo	noạo
najo	noại
naco	noạc
nafo	noạng
nano	noạn
namo	noạm
navo	noạp
naro	noạt

ne1l	nẹ
neul	nẹo
nejl	nẹi
necl	nẹc
nefl	nẹng
nenl	nẹn
neml	nẹm
nevl	nẹp
nerl	nẹt

ne1o	noẹ
neuo	noẹo
nejo	noẹi
neco	noẹc
nefo	noẹng
neno	noẹn
nemo	noẹm
nevo	noẹp
nero	noẹt

nd1l	nệ
ndul	nệu
ndjl	nệy
ndcl	nệch
ndfl	nệnh
ndnl	nện
ndml	nệm
ndvl	nệp
ndrl	nệt

nd1o	nuệ
nduo	nuệu
ndjo	nuệy
ndco	nuệch
ndfo	nuệnh
ndno	nuện
ndmo	nuệm
ndvo	nuệp
ndro	nuệt

ni1l	nị
niul	nịu
nijl	nỵ
nicl	nịch
nifl	nịnh
ninl	nịn
niml	nịm
nivl	nịp
nirl	nịt

ni1o	nuị
niuo	nuỵu
nijo	nuỵ
nico	nuỵch
nifo	nuỵnh
nino	nuỵn
nimo	nuỵm
nivo	nuỵp
niro	nuỵt

nk1l	nịa
nkul	niệu
nkjl	niệy
nkcl	niệc
nkfl	niệng
nknl	niện
nkml	niệm
nkvl	niệp
nkrl	niệt

nk1o	nuỵa
nkuo	nuyệu
nkjo	nuyệy
nkco	nuyệc
nkfo	nuyệng
nkno	nuyện
nkmo	nuyệm
nkvo	nuyệp
nkro	nuyệt

nl1l	nộ
nlul	nộu
nljl	nội
nlcl	nộc
nlfl	nộng
nlnl	nộn
nlml	nộm
nlvl	nộp
nlrl	nột

nl1o	noộ
nluo	noộu
nljo	noội
nlco	noộc
nlfo	noộng
nlno	noộn
nlmo	noộm
nlvo	noộp
nlro	noột

ns1l	nạnh
nsul	nậu
nsjl	nậy
nscl	nậc
nsfl	nậng
nsnl	nận
nsml	nậm
nsvl	nập
nsrl	nật

ns1o	noạnh
nsuo	nuậu
nsjo	nuậy
nsco	nuậc
nsfo	nuậng
nsno	nuận
nsmo	nuậm
nsvo	nuập
nsro	nuật

nq1l	nạch
nqul	nạu
nqjl	nạy
nqcl	nặc
nqfl	nặng
nqnl	nặn
nqml	nặm
nqvl	nặp
nqrl	nặt

nq1o	noạch
nquo	noạu
nqjo	noạy
nqco	noặc
nqfo	noặng
nqno	noặn
nqmo	noặm
nqvo	noặp
nqro	noặt

nt1l	nự
ntul	nựu
ntjl	nựi
ntcl	nực
ntfl	nựng
ntnl	nựn
ntml	nựm
ntvl	nựp
ntrl	nựt

nt1o	nựa
ntuo	nượu
ntjo	nượi
ntco	nược
ntfo	nượng
ntno	nượn
ntmo	nượm
ntvo	nượp
ntro	nượt

np1l	nụ
npul	nụu
npjl	nụi
npcl	nục
npfl	nụng
npnl	nụn
npml	nụm
npvl	nụp
nprl	nụt

np1o	nụa
npuo	nuộu
npjo	nuội
npco	nuộc
npfo	nuộng
npno	nuộn
npmo	nuộm
npvo	nuộp
npro	nuột

iw1l	nhợ
iwul	nhợu
iwjl	nhợi
iwcl	nhợc
iwfl	nhợng
iwnl	nhợn
iwml	nhợm
iwvl	nhợp
iwrl	nhợt

iw1o	nhuợ
iwuo	nhuợu
iwjo	nhuợi
iwco	nhuợc
iwfo	nhuợng
iwno	nhuợn
iwmo	nhuợm
iwvo	nhuợp
iwro	nhuợt

io1l	nhọ
ioul	nhọu
iojl	nhọi
iocl	nhọc
iofl	nhọng
ionl	nhọn
ioml	nhọm
iovl	nhọp
iorl	nhọt

io1o	nhoọ
iouo	nhoọu
iojo	nhoọi
ioco	nhoọc
iofo	nhoọng
iono	nhoọn
iomo	nhoọm
iovo	nhoọp
ioro	nhoọt

ia1l	nhạ
iaul	nhạo
iajl	nhại
iacl	nhạc
iafl	nhạng
ianl	nhạn
iaml	nhạm
iavl	nhạp
iarl	nhạt

ia1o	nhoạ
iauo	nhoạo
iajo	nhoại
iaco	nhoạc
iafo	nhoạng
iano	nhoạn
iamo	nhoạm
iavo	nhoạp
iaro	nhoạt

ie1l	nhẹ
ieul	nhẹo
iejl	nhẹi
iecl	nhẹc
iefl	nhẹng
ienl	nhẹn
ieml	nhẹm
ievl	nhẹp
ierl	nhẹt

ie1o	nhoẹ
ieuo	nhoẹo
iejo	nhoẹi
ieco	nhoẹc
iefo	nhoẹng
ieno	nhoẹn
iemo	nhoẹm
ievo	nhoẹp
iero	nhoẹt

id1l	nhệ
idul	nhệu
idjl	nhệy
idcl	nhệch
idfl	nhệnh
idnl	nhện
idml	nhệm
idvl	nhệp
idrl	nhệt

id1o	nhuệ
iduo	nhuệu
idjo	nhuệy
idco	nhuệch
idfo	nhuệnh
idno	nhuện
idmo	nhuệm
idvo	nhuệp
idro	nhuệt

ii1l	nhị
iiul	nhịu
iijl	nhỵ
iicl	nhịch
iifl	nhịnh
iinl	nhịn
iiml	nhịm
iivl	nhịp
iirl	nhịt

ii1o	nhuị
iiuo	nhuỵu
iijo	nhuỵ
iico	nhuỵch
iifo	nhuỵnh
iino	nhuỵn
iimo	nhuỵm
iivo	nhuỵp
iiro	nhuỵt

ik1l	nhịa
ikul	nhiệu
ikjl	nhiệy
ikcl	nhiệc
ikfl	nhiệng
iknl	nhiện
ikml	nhiệm
ikvl	nhiệp
ikrl	nhiệt

ik1o	nhuỵa
ikuo	nhuyệu
ikjo	nhuyệy
ikco	nhuyệc
ikfo	nhuyệng
ikno	nhuyện
ikmo	nhuyệm
ikvo	nhuyệp
ikro	nhuyệt

il1l	nhộ
ilul	nhộu
iljl	nhội
ilcl	nhộc
ilfl	nhộng
ilnl	nhộn
ilml	nhộm
ilvl	nhộp
ilrl	nhột

il1o	nhoộ
iluo	nhoộu
iljo	nhoội
ilco	nhoộc
ilfo	nhoộng
ilno	nhoộn
ilmo	nhoộm
ilvo	nhoộp
ilro	nhoột

is1l	nhạnh
isul	nhậu
isjl	nhậy
iscl	nhậc
isfl	nhậng
isnl	nhận
isml	nhậm
isvl	nhập
isrl	nhật

is1o	nhoạnh
isuo	nhuậu
isjo	nhuậy
isco	nhuậc
isfo	nhuậng
isno	nhuận
ismo	nhuậm
isvo	nhuập
isro	nhuật

iq1l	nhạch
iqul	nhạu
iqjl	nhạy
iqcl	nhặc
iqfl	nhặng
iqnl	nhặn
iqml	nhặm
iqvl	nhặp
iqrl	nhặt

iq1o	nhoạch
iquo	nhoạu
iqjo	nhoạy
iqco	nhoặc
iqfo	nhoặng
iqno	nhoặn
iqmo	nhoặm
iqvo	nhoặp
iqro	nhoặt

it1l	nhự
itul	nhựu
itjl	nhựi
itcl	nhực
itfl	nhựng
itnl	nhựn
itml	nhựm
itvl	nhựp
itrl	nhựt

it1o	nhựa
ituo	nhượu
itjo	nhượi
itco	nhược
itfo	nhượng
itno	nhượn
itmo	nhượm
itvo	nhượp
itro	nhượt

ip1l	nhụ
ipul	nhụu
ipjl	nhụi
ipcl	nhục
ipfl	nhụng
ipnl	nhụn
ipml	nhụm
ipvl	nhụp
iprl	nhụt

ip1o	nhụa
ipuo	nhuộu
ipjo	nhuội
ipco	nhuộc
ipfo	nhuộng
ipno	nhuộn
ipmo	nhuộm
ipvo	nhuộp
ipro	nhuột

mw1l	mợ
mwul	mợu
mwjl	mợi
mwcl	mợc
mwfl	mợng
mwnl	mợn
mwml	mợm
mwvl	mợp
mwrl	mợt

mw1o	muợ
mwuo	muợu
mwjo	muợi
mwco	muợc
mwfo	muợng
mwno	muợn
mwmo	muợm
mwvo	muợp
mwro	muợt

mo1l	mọ
moul	mọu
mojl	mọi
mocl	mọc
mofl	mọng
monl	mọn
moml	mọm
movl	mọp
morl	mọt

mo1o	moọ
mouo	moọu
mojo	moọi
moco	moọc
mofo	moọng
mono	moọn
momo	moọm
movo	moọp
moro	moọt

ma1l	mạ
maul	mạo
majl	mại
macl	mạc
mafl	mạng
manl	mạn
maml	mạm
mavl	mạp
marl	mạt

ma1o	moạ
mauo	moạo
majo	moại
maco	moạc
mafo	moạng
mano	moạn
mamo	moạm
mavo	moạp
maro	moạt

me1l	mẹ
meul	mẹo
mejl	mẹi
mecl	mẹc
mefl	mẹng
menl	mẹn
meml	mẹm
mevl	mẹp
merl	mẹt

me1o	moẹ
meuo	moẹo
mejo	moẹi
meco	moẹc
mefo	moẹng
meno	moẹn
memo	moẹm
mevo	moẹp
mero	moẹt

md1l	mệ
mdul	mệu
mdjl	mệy
mdcl	mệch
mdfl	mệnh
mdnl	mện
mdml	mệm
mdvl	mệp
mdrl	mệt

md1o	muệ
mduo	muệu
mdjo	muệy
mdco	muệch
mdfo	muệnh
mdno	muện
mdmo	muệm
mdvo	muệp
mdro	muệt

mi1l	mị
miul	mịu
mijl	mỵ
micl	mịch
mifl	mịnh
minl	mịn
miml	mịm
mivl	mịp
mirl	mịt

mi1o	muị
miuo	muỵu
mijo	muỵ
mico	muỵch
mifo	muỵnh
mino	muỵn
mimo	muỵm
mivo	muỵp
miro	muỵt

mk1l	mịa
mkul	miệu
mkjl	miệy
mkcl	miệc
mkfl	miệng
mknl	miện
mkml	miệm
mkvl	miệp
mkrl	miệt

mk1o	muỵa
mkuo	muyệu
mkjo	muyệy
mkco	muyệc
mkfo	muyệng
mkno	muyện
mkmo	muyệm
mkvo	muyệp
mkro	muyệt

ml1l	mộ
mlul	mộu
mljl	mội
mlcl	mộc
mlfl	mộng
mlnl	mộn
mlml	mộm
mlvl	mộp
mlrl	một

ml1o	moộ
mluo	moộu
mljo	moội
mlco	moộc
mlfo	moộng
mlno	moộn
mlmo	moộm
mlvo	moộp
mlro	moột

ms1l	mạnh
msul	mậu
msjl	mậy
mscl	mậc
msfl	mậng
msnl	mận
msml	mậm
msvl	mập
msrl	mật

ms1o	moạnh
msuo	muậu
msjo	muậy
msco	muậc
msfo	muậng
msno	muận
msmo	muậm
msvo	muập
msro	muật

mq1l	mạch
mqul	mạu
mqjl	mạy
mqcl	mặc
mqfl	mặng
mqnl	mặn
mqml	mặm
mqvl	mặp
mqrl	mặt

mq1o	moạch
mquo	moạu
mqjo	moạy
mqco	moặc
mqfo	moặng
mqno	moặn
mqmo	moặm
mqvo	moặp
mqro	moặt

mt1l	mự
mtul	mựu
mtjl	mựi
mtcl	mực
mtfl	mựng
mtnl	mựn
mtml	mựm
mtvl	mựp
mtrl	mựt

mt1o	mựa
mtuo	mượu
mtjo	mượi
mtco	mược
mtfo	mượng
mtno	mượn
mtmo	mượm
mtvo	mượp
mtro	mượt

mp1l	mụ
mpul	mụu
mpjl	mụi
mpcl	mục
mpfl	mụng
mpnl	mụn
mpml	mụm
mpvl	mụp
mprl	mụt

mp1o	mụa
mpuo	muộu
mpjo	muội
mpco	muộc
mpfo	muộng
mpno	muộn
mpmo	muộm
mpvo	muộp
mpro	muột

fw1l	phợ
fwul	phợu
fwjl	phợi
fwcl	phợc
fwfl	phợng
fwnl	phợn
fwml	phợm
fwvl	phợp
fwrl	phợt

fw1o	phuợ
fwuo	phuợu
fwjo	phuợi
fwco	phuợc
fwfo	phuợng
fwno	phuợn
fwmo	phuợm
fwvo	phuợp
fwro	phuợt

fo1l	phọ
foul	phọu
fojl	phọi
focl	phọc
fofl	phọng
fonl	phọn
foml	phọm
fovl	phọp
forl	phọt

fo1o	phoọ
fouo	phoọu
fojo	phoọi
foco	phoọc
fofo	phoọng
fono	phoọn
fomo	phoọm
fovo	phoọp
foro	phoọt

fa1l	phạ
faul	phạo
fajl	phại
facl	phạc
fafl	phạng
fanl	phạn
faml	phạm
favl	phạp
farl	phạt

fa1o	phoạ
fauo	phoạo
fajo	phoại
faco	phoạc
fafo	phoạng
fano	phoạn
famo	phoạm
favo	phoạp
faro	phoạt

fe1l	phẹ
feul	phẹo
fejl	phẹi
fecl	phẹc
fefl	phẹng
fenl	phẹn
feml	phẹm
fevl	phẹp
ferl	phẹt

fe1o	phoẹ
feuo	phoẹo
fejo	phoẹi
feco	phoẹc
fefo	phoẹng
feno	phoẹn
femo	phoẹm
fevo	phoẹp
fero	phoẹt

fd1l	phệ
fdul	phệu
fdjl	phệy
fdcl	phệch
fdfl	phệnh
fdnl	phện
fdml	phệm
fdvl	phệp
fdrl	phệt

fd1o	phuệ
fduo	phuệu
fdjo	phuệy
fdco	phuệch
fdfo	phuệnh
fdno	phuện
fdmo	phuệm
fdvo	phuệp
fdro	phuệt

fi1l	phị
fiul	phịu
fijl	phỵ
ficl	phịch
fifl	phịnh
finl	phịn
fiml	phịm
fivl	phịp
firl	phịt

fi1o	phuị
fiuo	phuỵu
fijo	phuỵ
fico	phuỵch
fifo	phuỵnh
fino	phuỵn
fimo	phuỵm
fivo	phuỵp
firo	phuỵt

fk1l	phịa
fkul	phiệu
fkjl	phiệy
fkcl	phiệc
fkfl	phiệng
fknl	phiện
fkml	phiệm
fkvl	phiệp
fkrl	phiệt

fk1o	phuỵa
fkuo	phuyệu
fkjo	phuyệy
fkco	phuyệc
fkfo	phuyệng
fkno	phuyện
fkmo	phuyệm
fkvo	phuyệp
fkro	phuyệt

fl1l	phộ
flul	phộu
fljl	phội
flcl	phộc
flfl	phộng
flnl	phộn
flml	phộm
flvl	phộp
flrl	phột

fl1o	phoộ
fluo	phoộu
fljo	phoội
flco	phoộc
flfo	phoộng
flno	phoộn
flmo	phoộm
flvo	phoộp
flro	phoột

fs1l	phạnh
fsul	phậu
fsjl	phậy
fscl	phậc
fsfl	phậng
fsnl	phận
fsml	phậm
fsvl	phập
fsrl	phật

fs1o	phoạnh
fsuo	phuậu
fsjo	phuậy
fsco	phuậc
fsfo	phuậng
fsno	phuận
fsmo	phuậm
fsvo	phuập
fsro	phuật

fq1l	phạch
fqul	phạu
fqjl	phạy
fqcl	phặc
fqfl	phặng
fqnl	phặn
fqml	phặm
fqvl	phặp
fqrl	phặt

fq1o	phoạch
fquo	phoạu
fqjo	phoạy
fqco	phoặc
fqfo	phoặng
fqno	phoặn
fqmo	phoặm
fqvo	phoặp
fqro	phoặt

ft1l	phự
ftul	phựu
ftjl	phựi
ftcl	phực
ftfl	phựng
ftnl	phựn
ftml	phựm
ftvl	phựp
ftrl	phựt

ft1o	phựa
ftuo	phượu
ftjo	phượi
ftco	phược
ftfo	phượng
ftno	phượn
ftmo	phượm
ftvo	phượp
ftro	phượt

fp1l	phụ
fpul	phụu
fpjl	phụi
fpcl	phục
fpfl	phụng
fpnl	phụn
fpml	phụm
fpvl	phụp
fprl	phụt

fp1o	phụa
fpuo	phuộu
fpjo	phuội
fpco	phuộc
fpfo	phuộng
fpno	phuộn
fpmo	phuộm
fpvo	phuộp
fpro	phuột

vw1l	vợ
vwul	vợu
vwjl	vợi
vwcl	vợc
vwfl	vợng
vwnl	vợn
vwml	vợm
vwvl	vợp
vwrl	vợt

vw1o	vuợ
vwuo	vuợu
vwjo	vuợi
vwco	vuợc
vwfo	vuợng
vwno	vuợn
vwmo	vuợm
vwvo	vuợp
vwro	vuợt

vo1l	vọ
voul	vọu
vojl	vọi
vocl	vọc
vofl	vọng
vonl	vọn
voml	vọm
vovl	vọp
vorl	vọt

vo1o	voọ
vouo	voọu
vojo	voọi
voco	voọc
vofo	voọng
vono	voọn
vomo	voọm
vovo	voọp
voro	voọt

va1l	vạ
vaul	vạo
vajl	vại
vacl	vạc
vafl	vạng
vanl	vạn
vaml	vạm
vavl	vạp
varl	vạt

va1o	voạ
vauo	voạo
vajo	voại
vaco	voạc
vafo	voạng
vano	voạn
vamo	voạm
vavo	voạp
varo	voạt

ve1l	vẹ
veul	vẹo
vejl	vẹi
vecl	vẹc
vefl	vẹng
venl	vẹn
veml	vẹm
vevl	vẹp
verl	vẹt

ve1o	voẹ
veuo	voẹo
vejo	voẹi
veco	voẹc
vefo	voẹng
veno	voẹn
vemo	voẹm
vevo	voẹp
vero	voẹt

vd1l	vệ
vdul	vệu
vdjl	vệy
vdcl	vệch
vdfl	vệnh
vdnl	vện
vdml	vệm
vdvl	vệp
vdrl	vệt

vd1o	vuệ
vduo	vuệu
vdjo	vuệy
vdco	vuệch
vdfo	vuệnh
vdno	vuện
vdmo	vuệm
vdvo	vuệp
vdro	vuệt

vi1l	vị
viul	vịu
vijl	vỵ
vicl	vịch
vifl	vịnh
vinl	vịn
viml	vịm
vivl	vịp
virl	vịt

vi1o	vuị
viuo	vuỵu
vijo	vuỵ
vico	vuỵch
vifo	vuỵnh
vino	vuỵn
vimo	vuỵm
vivo	vuỵp
viro	vuỵt

vk1l	vịa
vkul	việu
vkjl	việy
vkcl	việc
vkfl	việng
vknl	viện
vkml	việm
vkvl	việp
vkrl	việt

vk1o	vuỵa
vkuo	vuyệu
vkjo	vuyệy
vkco	vuyệc
vkfo	vuyệng
vkno	vuyện
vkmo	vuyệm
vkvo	vuyệp
vkro	vuyệt

vl1l	vộ
vlul	vộu
vljl	vội
vlcl	vộc
vlfl	vộng
vlnl	vộn
vlml	vộm
vlvl	vộp
vlrl	vột

vl1o	voộ
vluo	voộu
vljo	voội
vlco	voộc
vlfo	voộng
vlno	voộn
vlmo	voộm
vlvo	voộp
vlro	voột

vs1l	vạnh
vsul	vậu
vsjl	vậy
vscl	vậc
vsfl	vậng
vsnl	vận
vsml	vậm
vsvl	vập
vsrl	vật

vs1o	voạnh
vsuo	vuậu
vsjo	vuậy
vsco	vuậc
vsfo	vuậng
vsno	vuận
vsmo	vuậm
vsvo	vuập
vsro	vuật

vq1l	vạch
vqul	vạu
vqjl	vạy
vqcl	vặc
vqfl	vặng
vqnl	vặn
vqml	vặm
vqvl	vặp
vqrl	vặt

vq1o	voạch
vquo	voạu
vqjo	voạy
vqco	voặc
vqfo	voặng
vqno	voặn
vqmo	voặm
vqvo	voặp
vqro	voặt

vt1l	vự
vtul	vựu
vtjl	vựi
vtcl	vực
vtfl	vựng
vtnl	vựn
vtml	vựm
vtvl	vựp
vtrl	vựt

vt1o	vựa
vtuo	vượu
vtjo	vượi
vtco	vược
vtfo	vượng
vtno	vượn
vtmo	vượm
vtvo	vượp
vtro	vượt

vp1l	vụ
vpul	vụu
vpjl	vụi
vpcl	vục
vpfl	vụng
vpnl	vụn
vpml	vụm
vpvl	vụp
vprl	vụt

vp1o	vụa
vpuo	vuộu
vpjo	vuội
vpco	vuộc
vpfo	vuộng
vpno	vuộn
vpmo	vuộm
vpvo	vuộp
vpro	vuột

ew1l	bợ
ewul	bợu
ewjl	bợi
ewcl	bợc
ewfl	bợng
ewnl	bợn
ewml	bợm
ewvl	bợp
ewrl	bợt

ew1o	buợ
ewuo	buợu
ewjo	buợi
ewco	buợc
ewfo	buợng
ewno	buợn
ewmo	buợm
ewvo	buợp
ewro	buợt

eo1l	bọ
eoul	bọu
eojl	bọi
eocl	bọc
eofl	bọng
eonl	bọn
eoml	bọm
eovl	bọp
eorl	bọt

eo1o	boọ
eouo	boọu
eojo	boọi
eoco	boọc
eofo	boọng
eono	boọn
eomo	boọm
eovo	boọp
eoro	boọt

ea1l	bạ
eaul	bạo
eajl	bại
eacl	bạc
eafl	bạng
eanl	bạn
eaml	bạm
eavl	bạp
earl	bạt

ea1o	boạ
eauo	boạo
eajo	boại
eaco	boạc
eafo	boạng
eano	boạn
eamo	boạm
eavo	boạp
earo	boạt

ee1l	bẹ
eeul	bẹo
eejl	bẹi
eecl	bẹc
eefl	bẹng
eenl	bẹn
eeml	bẹm
eevl	bẹp
eerl	bẹt

ee1o	boẹ
eeuo	boẹo
eejo	boẹi
eeco	boẹc
eefo	boẹng
eeno	boẹn
eemo	boẹm
eevo	boẹp
eero	boẹt

ed1l	bệ
edul	bệu
edjl	bệy
edcl	bệch
edfl	bệnh
ednl	bện
edml	bệm
edvl	bệp
edrl	bệt

ed1o	buệ
eduo	buệu
edjo	buệy
edco	buệch
edfo	buệnh
edno	buện
edmo	buệm
edvo	buệp
edro	buệt

ei1l	bị
eiul	bịu
eijl	bỵ
eicl	bịch
eifl	bịnh
einl	bịn
eiml	bịm
eivl	bịp
eirl	bịt

ei1o	buị
eiuo	buỵu
eijo	buỵ
eico	buỵch
eifo	buỵnh
eino	buỵn
eimo	buỵm
eivo	buỵp
eiro	buỵt

ek1l	bịa
ekul	biệu
ekjl	biệy
ekcl	biệc
ekfl	biệng
eknl	biện
ekml	biệm
ekvl	biệp
ekrl	biệt

ek1o	buỵa
ekuo	buyệu
ekjo	buyệy
ekco	buyệc
ekfo	buyệng
ekno	buyện
ekmo	buyệm
ekvo	buyệp
ekro	buyệt

el1l	bộ
elul	bộu
eljl	bội
elcl	bộc
elfl	bộng
elnl	bộn
elml	bộm
elvl	bộp
elrl	bột

el1o	boộ
eluo	boộu
eljo	boội
elco	boộc
elfo	boộng
elno	boộn
elmo	boộm
elvo	boộp
elro	boột

es1l	bạnh
esul	bậu
esjl	bậy
escl	bậc
esfl	bậng
esnl	bận
esml	bậm
esvl	bập
esrl	bật

es1o	boạnh
esuo	buậu
esjo	buậy
esco	buậc
esfo	buậng
esno	buận
esmo	buậm
esvo	buập
esro	buật

eq1l	bạch
equl	bạu
eqjl	bạy
eqcl	bặc
eqfl	bặng
eqnl	bặn
eqml	bặm
eqvl	bặp
eqrl	bặt

eq1o	boạch
equo	boạu
eqjo	boạy
eqco	boặc
eqfo	boặng
eqno	boặn
eqmo	boặm
eqvo	boặp
eqro	boặt

et1l	bự
etul	bựu
etjl	bựi
etcl	bực
etfl	bựng
etnl	bựn
etml	bựm
etvl	bựp
etrl	bựt

et1o	bựa
etuo	bượu
etjo	bượi
etco	bược
etfo	bượng
etno	bượn
etmo	bượm
etvo	bượp
etro	bượt

ep1l	bụ
epul	bụu
epjl	bụi
epcl	bục
epfl	bụng
epnl	bụn
epml	bụm
epvl	bụp
eprl	bụt

ep1o	bụa
epuo	buộu
epjo	buội
epco	buộc
epfo	buộng
epno	buộn
epmo	buộm
epvo	buộp
epro	buột

sw1l	sợ
swul	sợu
swjl	sợi
swcl	sợc
swfl	sợng
swnl	sợn
swml	sợm
swvl	sợp
swrl	sợt

sw1o	suợ
swuo	suợu
swjo	suợi
swco	suợc
swfo	suợng
swno	suợn
swmo	suợm
swvo	suợp
swro	suợt

so1l	sọ
soul	sọu
sojl	sọi
socl	sọc
sofl	sọng
sonl	sọn
soml	sọm
sovl	sọp
sorl	sọt

so1o	soọ
souo	soọu
sojo	soọi
soco	soọc
sofo	soọng
sono	soọn
somo	soọm
sovo	soọp
soro	soọt

sa1l	sạ
saul	sạo
sajl	sại
sacl	sạc
safl	sạng
sanl	sạn
saml	sạm
savl	sạp
sarl	sạt

sa1o	soạ
sauo	soạo
sajo	soại
saco	soạc
safo	soạng
sano	soạn
samo	soạm
savo	soạp
saro	soạt

se1l	sẹ
seul	sẹo
sejl	sẹi
secl	sẹc
sefl	sẹng
senl	sẹn
seml	sẹm
sevl	sẹp
serl	sẹt

se1o	soẹ
seuo	soẹo
sejo	soẹi
seco	soẹc
sefo	soẹng
seno	soẹn
semo	soẹm
sevo	soẹp
sero	soẹt

sd1l	sệ
sdul	sệu
sdjl	sệy
sdcl	sệch
sdfl	sệnh
sdnl	sện
sdml	sệm
sdvl	sệp
sdrl	sệt

sd1o	suệ
sduo	suệu
sdjo	suệy
sdco	suệch
sdfo	suệnh
sdno	suện
sdmo	suệm
sdvo	suệp
sdro	suệt

si1l	sị
siul	sịu
sijl	sỵ
sicl	sịch
sifl	sịnh
sinl	sịn
siml	sịm
sivl	sịp
sirl	sịt

si1o	suị
siuo	suỵu
sijo	suỵ
sico	suỵch
sifo	suỵnh
sino	suỵn
simo	suỵm
sivo	suỵp
siro	suỵt

sk1l	sịa
skul	siệu
skjl	siệy
skcl	siệc
skfl	siệng
sknl	siện
skml	siệm
skvl	siệp
skrl	siệt

sk1o	suỵa
skuo	suyệu
skjo	suyệy
skco	suyệc
skfo	suyệng
skno	suyện
skmo	suyệm
skvo	suyệp
skro	suyệt

sl1l	sộ
slul	sộu
sljl	sội
slcl	sộc
slfl	sộng
slnl	sộn
slml	sộm
slvl	sộp
slrl	sột

sl1o	soộ
sluo	soộu
sljo	soội
slco	soộc
slfo	soộng
slno	soộn
slmo	soộm
slvo	soộp
slro	soột

ss1l	sạnh
ssul	sậu
ssjl	sậy
sscl	sậc
ssfl	sậng
ssnl	sận
ssml	sậm
ssvl	sập
ssrl	sật

ss1o	soạnh
ssuo	suậu
ssjo	suậy
ssco	suậc
ssfo	suậng
ssno	suận
ssmo	suậm
ssvo	suập
ssro	suật

sq1l	sạch
squl	sạu
sqjl	sạy
sqcl	sặc
sqfl	sặng
sqnl	sặn
sqml	sặm
sqvl	sặp
sqrl	sặt

sq1o	soạch
squo	soạu
sqjo	soạy
sqco	soặc
sqfo	soặng
sqno	soặn
sqmo	soặm
sqvo	soặp
sqro	soặt

st1l	sự
stul	sựu
stjl	sựi
stcl	sực
stfl	sựng
stnl	sựn
stml	sựm
stvl	sựp
strl	sựt

st1o	sựa
stuo	sượu
stjo	sượi
stco	sược
stfo	sượng
stno	sượn
stmo	sượm
stvo	sượp
stro	sượt

sp1l	sụ
spul	sụu
spjl	sụi
spcl	sục
spfl	sụng
spnl	sụn
spml	sụm
spvl	sụp
sprl	sụt

sp1o	sụa
spuo	suộu
spjo	suội
spco	suộc
spfo	suộng
spno	suộn
spmo	suộm
spvo	suộp
spro	suột

xw1l	xợ
xwul	xợu
xwjl	xợi
xwcl	xợc
xwfl	xợng
xwnl	xợn
xwml	xợm
xwvl	xợp
xwrl	xợt

xw1o	xuợ
xwuo	xuợu
xwjo	xuợi
xwco	xuợc
xwfo	xuợng
xwno	xuợn
xwmo	xuợm
xwvo	xuợp
xwro	xuợt

xo1l	xọ
xoul	xọu
xojl	xọi
xocl	xọc
xofl	xọng
xonl	xọn
xoml	xọm
xovl	xọp
xorl	xọt

xo1o	xoọ
xouo	xoọu
xojo	xoọi
xoco	xoọc
xofo	xoọng
xono	xoọn
xomo	xoọm
xovo	xoọp
xoro	xoọt

xa1l	xạ
xaul	xạo
xajl	xại
xacl	xạc
xafl	xạng
xanl	xạn
xaml	xạm
xavl	xạp
xarl	xạt

xa1o	xoạ
xauo	xoạo
xajo	xoại
xaco	xoạc
xafo	xoạng
xano	xoạn
xamo	xoạm
xavo	xoạp
xaro	xoạt

xe1l	xẹ
xeul	xẹo
xejl	xẹi
xecl	xẹc
xefl	xẹng
xenl	xẹn
xeml	xẹm
xevl	xẹp
xerl	xẹt

xe1o	xoẹ
xeuo	xoẹo
xejo	xoẹi
xeco	xoẹc
xefo	xoẹng
xeno	xoẹn
xemo	xoẹm
xevo	xoẹp
xero	xoẹt

xd1l	xệ
xdul	xệu
xdjl	xệy
xdcl	xệch
xdfl	xệnh
xdnl	xện
xdml	xệm
xdvl	xệp
xdrl	xệt

xd1o	xuệ
xduo	xuệu
xdjo	xuệy
xdco	xuệch
xdfo	xuệnh
xdno	xuện
xdmo	xuệm
xdvo	xuệp
xdro	xuệt

xi1l	xị
xiul	xịu
xijl	xỵ
xicl	xịch
xifl	xịnh
xinl	xịn
ximl	xịm
xivl	xịp
xirl	xịt

xi1o	xuị
xiuo	xuỵu
xijo	xuỵ
xico	xuỵch
xifo	xuỵnh
xino	xuỵn
ximo	xuỵm
xivo	xuỵp
xiro	xuỵt

xk1l	xịa
xkul	xiệu
xkjl	xiệy
xkcl	xiệc
xkfl	xiệng
xknl	xiện
xkml	xiệm
xkvl	xiệp
xkrl	xiệt

xk1o	xuỵa
xkuo	xuyệu
xkjo	xuyệy
xkco	xuyệc
xkfo	xuyệng
xkno	xuyện
xkmo	xuyệm
xkvo	xuyệp
xkro	xuyệt

xl1l	xộ
xlul	xộu
xljl	xội
xlcl	xộc
xlfl	xộng
xlnl	xộn
xlml	xộm
xlvl	xộp
xlrl	xột

xl1o	xoộ
xluo	xoộu
xljo	xoội
xlco	xoộc
xlfo	xoộng
xlno	xoộn
xlmo	xoộm
xlvo	xoộp
xlro	xoột

xs1l	xạnh
xsul	xậu
xsjl	xậy
xscl	xậc
xsfl	xậng
xsnl	xận
xsml	xậm
xsvl	xập
xsrl	xật

xs1o	xoạnh
xsuo	xuậu
xsjo	xuậy
xsco	xuậc
xsfo	xuậng
xsno	xuận
xsmo	xuậm
xsvo	xuập
xsro	xuật

xq1l	xạch
xqul	xạu
xqjl	xạy
xqcl	xặc
xqfl	xặng
xqnl	xặn
xqml	xặm
xqvl	xặp
xqrl	xặt

xq1o	xoạch
xquo	xoạu
xqjo	xoạy
xqco	xoặc
xqfo	xoặng
xqno	xoặn
xqmo	xoặm
xqvo	xoặp
xqro	xoặt

xt1l	xự
xtul	xựu
xtjl	xựi
xtcl	xực
xtfl	xựng
xtnl	xựn
xtml	xựm
xtvl	xựp
xtrl	xựt

xt1o	xựa
xtuo	xượu
xtjo	xượi
xtco	xược
xtfo	xượng
xtno	xượn
xtmo	xượm
xtvo	xượp
xtro	xượt

xp1l	xụ
xpul	xụu
xpjl	xụi
xpcl	xục
xpfl	xụng
xpnl	xụn
xpml	xụm
xpvl	xụp
xprl	xụt

xp1o	xụa
xpuo	xuộu
xpjo	xuội
xpco	xuộc
xpfo	xuộng
xpno	xuộn
xpmo	xuộm
xpvo	xuộp
xpro	xuột

kw1l	khợ
kwul	khợu
kwjl	khợi
kwcl	khợc
kwfl	khợng
kwnl	khợn
kwml	khợm
kwvl	khợp
kwrl	khợt

kw1o	khuợ
kwuo	khuợu
kwjo	khuợi
kwco	khuợc
kwfo	khuợng
kwno	khuợn
kwmo	khuợm
kwvo	khuợp
kwro	khuợt

ko1l	khọ
koul	khọu
kojl	khọi
kocl	khọc
kofl	khọng
konl	khọn
koml	khọm
kovl	khọp
korl	khọt

ko1o	khoọ
kouo	khoọu
kojo	khoọi
koco	khoọc
kofo	khoọng
kono	khoọn
komo	khoọm
kovo	khoọp
koro	khoọt

ka1l	khạ
kaul	khạo
kajl	khại
kacl	khạc
kafl	khạng
kanl	khạn
kaml	khạm
kavl	khạp
karl	khạt

ka1o	khoạ
kauo	khoạo
kajo	khoại
kaco	khoạc
kafo	khoạng
kano	khoạn
kamo	khoạm
kavo	khoạp
karo	khoạt

ke1l	khẹ
keul	khẹo
kejl	khẹi
kecl	khẹc
kefl	khẹng
kenl	khẹn
keml	khẹm
kevl	khẹp
kerl	khẹt

ke1o	khoẹ
keuo	khoẹo
kejo	khoẹi
keco	khoẹc
kefo	khoẹng
keno	khoẹn
kemo	khoẹm
kevo	khoẹp
kero	khoẹt

kd1l	khệ
kdul	khệu
kdjl	khệy
kdcl	khệch
kdfl	khệnh
kdnl	khện
kdml	khệm
kdvl	khệp
kdrl	khệt

kd1o	khuệ
kduo	khuệu
kdjo	khuệy
kdco	khuệch
kdfo	khuệnh
kdno	khuện
kdmo	khuệm
kdvo	khuệp
kdro	khuệt

ki1l	khị
kiul	khịu
kijl	khỵ
kicl	khịch
kifl	khịnh
kinl	khịn
kiml	khịm
kivl	khịp
kirl	khịt

ki1o	khuị
kiuo	khuỵu
kijo	khuỵ
kico	khuỵch
kifo	khuỵnh
kino	khuỵn
kimo	khuỵm
kivo	khuỵp
kiro	khuỵt

kk1l	khịa
kkul	khiệu
kkjl	khiệy
kkcl	khiệc
kkfl	khiệng
kknl	khiện
kkml	khiệm
kkvl	khiệp
kkrl	khiệt

kk1o	khuỵa
kkuo	khuyệu
kkjo	khuyệy
kkco	khuyệc
kkfo	khuyệng
kkno	khuyện
kkmo	khuyệm
kkvo	khuyệp
kkro	khuyệt

kl1l	khộ
klul	khộu
kljl	khội
klcl	khộc
klfl	khộng
klnl	khộn
klml	khộm
klvl	khộp
klrl	khột

kl1o	khoộ
kluo	khoộu
kljo	khoội
klco	khoộc
klfo	khoộng
klno	khoộn
klmo	khoộm
klvo	khoộp
klro	khoột

ks1l	khạnh
ksul	khậu
ksjl	khậy
kscl	khậc
ksfl	khậng
ksnl	khận
ksml	khậm
ksvl	khập
ksrl	khật

ks1o	khoạnh
ksuo	khuậu
ksjo	khuậy
ksco	khuậc
ksfo	khuậng
ksno	khuận
ksmo	khuậm
ksvo	khuập
ksro	khuật

kq1l	khạch
kqul	khạu
kqjl	khạy
kqcl	khặc
kqfl	khặng
kqnl	khặn
kqml	khặm
kqvl	khặp
kqrl	khặt

kq1o	khoạch
kquo	khoạu
kqjo	khoạy
kqco	khoặc
kqfo	khoặng
kqno	khoặn
kqmo	khoặm
kqvo	khoặp
kqro	khoặt

kt1l	khự
ktul	khựu
ktjl	khựi
ktcl	khực
ktfl	khựng
ktnl	khựn
ktml	khựm
ktvl	khựp
ktrl	khựt

kt1o	khựa
ktuo	khượu
ktjo	khượi
ktco	khược
ktfo	khượng
ktno	khượn
ktmo	khượm
ktvo	khượp
ktro	khượt

kp1l	khụ
kpul	khụu
kpjl	khụi
kpcl	khục
kpfl	khụng
kpnl	khụn
kpml	khụm
kpvl	khụp
kprl	khụt

kp1o	khụa
kpuo	khuộu
kpjo	khuội
kpco	khuộc
kpfo	khuộng
kpno	khuộn
kpmo	khuộm
kpvo	khuộp
kpro	khuột

hw1l	hợ
hwul	hợu
hwjl	hợi
hwcl	hợc
hwfl	hợng
hwnl	hợn
hwml	hợm
hwvl	hợp
hwrl	hợt

hw1o	huợ
hwuo	huợu
hwjo	huợi
hwco	huợc
hwfo	huợng
hwno	huợn
hwmo	huợm
hwvo	huợp
hwro	huợt

ho1l	họ
houl	họu
hojl	họi
hocl	học
hofl	họng
honl	họn
homl	họm
hovl	họp
horl	họt

ho1o	hoọ
houo	hoọu
hojo	hoọi
hoco	hoọc
hofo	hoọng
hono	hoọn
homo	hoọm
hovo	hoọp
horo	hoọt

ha1l	hạ
haul	hạo
hajl	hại
hacl	hạc
hafl	hạng
hanl	hạn
haml	hạm
havl	hạp
harl	hạt

ha1o	hoạ
hauo	hoạo
hajo	hoại
haco	hoạc
hafo	hoạng
hano	hoạn
hamo	hoạm
havo	hoạp
haro	hoạt

he1l	hẹ
heul	hẹo
hejl	hẹi
hecl	hẹc
hefl	hẹng
henl	hẹn
heml	hẹm
hevl	hẹp
herl	hẹt

he1o	hoẹ
heuo	hoẹo
hejo	hoẹi
heco	hoẹc
hefo	hoẹng
heno	hoẹn
hemo	hoẹm
hevo	hoẹp
hero	hoẹt

hd1l	hệ
hdul	hệu
hdjl	hệy
hdcl	hệch
hdfl	hệnh
hdnl	hện
hdml	hệm
hdvl	hệp
hdrl	hệt

hd1o	huệ
hduo	huệu
hdjo	huệy
hdco	huệch
hdfo	huệnh
hdno	huện
hdmo	huệm
hdvo	huệp
hdro	huệt

hi1l	hị
hiul	hịu
hijl	hỵ
hicl	hịch
hifl	hịnh
hinl	hịn
himl	hịm
hivl	hịp
hirl	hịt

hi1o	huị
hiuo	huỵu
hijo	huỵ
hico	huỵch
hifo	huỵnh
hino	huỵn
himo	huỵm
hivo	huỵp
hiro	huỵt

hk1l	hịa
hkul	hiệu
hkjl	hiệy
hkcl	hiệc
hkfl	hiệng
hknl	hiện
hkml	hiệm
hkvl	hiệp
hkrl	hiệt

hk1o	huỵa
hkuo	huyệu
hkjo	huyệy
hkco	huyệc
hkfo	huyệng
hkno	huyện
hkmo	huyệm
hkvo	huyệp
hkro	huyệt

hl1l	hộ
hlul	hộu
hljl	hội
hlcl	hộc
hlfl	hộng
hlnl	hộn
hlml	hộm
hlvl	hộp
hlrl	hột

hl1o	hoộ
hluo	hoộu
hljo	hoội
hlco	hoộc
hlfo	hoộng
hlno	hoộn
hlmo	hoộm
hlvo	hoộp
hlro	hoột

hs1l	hạnh
hsul	hậu
hsjl	hậy
hscl	hậc
hsfl	hậng
hsnl	hận
hsml	hậm
hsvl	hập
hsrl	hật

hs1o	hoạnh
hsuo	huậu
hsjo	huậy
hsco	huậc
hsfo	huậng
hsno	huận
hsmo	huậm
hsvo	huập
hsro	huật

hq1l	hạch
hqul	hạu
hqjl	hạy
hqcl	hặc
hqfl	hặng
hqnl	hặn
hqml	hặm
hqvl	hặp
hqrl	hặt

hq1o	hoạch
hquo	hoạu
hqjo	hoạy
hqco	hoặc
hqfo	hoặng
hqno	hoặn
hqmo	hoặm
hqvo	hoặp
hqro	hoặt

ht1l	hự
htul	hựu
htjl	hựi
htcl	hực
htfl	hựng
htnl	hựn
html	hựm
htvl	hựp
htrl	hựt

ht1o	hựa
htuo	hượu
htjo	hượi
htco	hược
htfo	hượng
htno	hượn
htmo	hượm
htvo	hượp
htro	hượt

hp1l	hụ
hpul	hụu
hpjl	hụi
hpcl	hục
hpfl	hụng
hpnl	hụn
hpml	hụm
hpvl	hụp
hprl	hụt

hp1o	hụa
hpuo	huộu
hpjo	huội
hpco	huộc
hpfo	huộng
hpno	huộn
hpmo	huộm
hpvo	huộp
hpro	huột
