pk l	ịa
 kul	yệu
 kjl	yệy
 kcl	yệc
 kfl	yệng
 knl	yện
 kml	yệm
 kvl	yệp
 krl	yệt

pk o	uỵa
 kuo	uyệu
 kjo	uyệy
 kco	uyệc
 kfo	uyệng
 kno	uyện
 kmo	uyệm
 kvo	uyệp
 kro	uyệt

tk l	gỵa
tkul	giệu
tkjl	giệy
tkcl	giệc
tkfl	giệng
tknl	giện
tkml	giệm
tkvl	giệp
tkrl	giệt

tk o	giuỵa
tkuo	giuyệu
tkjo	giuyệy
tkco	giuyệc
tkfo	giuyệng
tkno	giuyện
tkmo	giuyệm
tkvo	giuyệp
tkro	giuyệt