pd l	ệ
 dul	ệu
 djl	ệy
 dcl	ệch
 dfl	ệnh
 dnl	ện
 dml	ệm
 dvl	ệp
 drl	ệt

pd o	uệ
 duo	uệu
 djo	uệy
 dco	uệch
 dfo	uệnh
 dno	uện
 dmo	uệm
 dvo	uệp
 dro	uệt

zd l	gệ
zdul	gệu
zdjl	gệy
zdcl	gệch
zdfl	gệnh
zdnl	gện
zdml	gệm
zdvl	gệp
zdrl	gệt

zd o	giuệ
zduo	giuệu
zdjo	giuệy
zdco	giuệch
zdfo	giuệnh
zdno	giuện
zdmo	giuệm
zdvo	giuệp
zdro	giuệt